111111111111111111
10000100P000000E01
100000000000000001
100000001100000001
100000000000000001
100110000000C00001
100000000000000001
100000000000000011
100111000000000001
111111111111111111