111111111111111111
10000100000P0C0E01
100000000000000001
100000001100000001
100000000000000001
100110000000000001
100000000000000001
100000000111111111
100111000000000001
111111111111111111
