11111111111111111111111111111
1P000000000000000000000000001
10000000001111111110000000001
10000000001C0C1C0C10000000001
10000000000000100000000000001
10000000001C0C1C0C10000000001
10000000001111111110000000001
11110000000000100000000001111
1C000000000001E10000000000001
11111111111111111111111111111
