111111111111111111111111111111
1P0000000000000000000000000001
100000000001111111110000000001
100000000001C0C1C0C10000000001
100000000000000100000000000001
100000000001C0C1C0C10000000001
100000000001111111110000000001
111100000000000100000000001111
1C0000000000001E100000000000C1
111111111111111111111111111111