111111111111111111
10C001000000000E01
100000000000000001
1000P0001100000001
100000000000000001
100110000000000001
100000000110000001
100000000111111111
100111000000000001
111111111111111111