111111111111111111
10C001000000000E01
100000000000000001
1000P0001100000001
10000000000C000001
100110000000000001
100000000000000001
100C00000111111111
10011100000C000001
111111111111111111
