111111111111111111
10C001000000000E01
100000000000000001
1000P0001100000001
100000000000000001
100110000000000001
100000000110000001
100000000111111111
100111000000010001
111111111111111111



111111111111111111
10000P0E0000C11111
111111111111111111
